NO					 ./path_to_the_north_texture
SO	 ./path_to_the_south_texture
			WE ./path_to_the_west_texture
		EA ./path_to_the_east_texture
	F 220,100,0
	C 225,30,0
	1111111111111111111111111
	1000000000110000000000001
	1011000001110000000000001
			10010000000000000 00000001
	1111111110110000011100000 00000001
	1000000000110000011101111 11111111
11110111111111011100000010001
1111011111111101110101001 0001
11000	000110101011100000010001
1000000	 0000000 00110000 0010001
1000000000000000 1101010010001
110000 0111010 1011111011110N0111
1111 0111 1110101 101111010001
1111 1111 1111111 111111111111
