NO ./path_to_the_north_texture
SO ./path_to_the_south_texture
WE ./path_to_the_west_texture
EA ./path_to_the_east_texture
F 221,111,1
C 225,31,1
00000000000000000000000000000000000000000000
11111111111111111111111111111111111
111111111111111111111111111
111111111111111111111111111
111111111111111111111111111
11111111111111111111111111111111111
11111111111111111111111111111111111
1111111111111111111111111111111
1111111111111111111111111111111
1111111111111111111111111111111
1111111111111111111111111111111
1111111111111111111111111111111
111111111111111111111111111N11111
111111111 1111111 1111111111111
111111111 1111111 1111111111111
111111111111111111111111111111111111111111
00000000000000000000000000000000000000000000000