NO ./path_to_the_north_texture
SO ./path_to_the_south_texture
WE ./path_to_the_west_texture
EA ./path_to_the_east_texture
F 220,000,0
C 225,30,0
11111111111111111111111111111111111
110000000000000000000000001
110000000000000000000000001
110000000000000000000000001
11000000000000000000000000000000001
11000000000000000000000000000000001
1100000000000000000000000000001
1100000000000000000000000000001
1100000000000000000000000000001
1100000000000000000000000000001
1100000000000000000000000000001
110000000000000000000000000N00001
110000000 0000000 0000000000001
110000000 0000000 0000000000001
111111111111111111111111111111111111111111111111111111